21 21 21 21 21 26 26 26 26 26 21 26 26 21 26 26 26 21 26 26 26 21 26 26 26 26 21 26 26 21 21 26 26 26 21 21 21 21 21 21 21 26 26 21 21 21 21 21 21 26
21 21 21 21 21 26 26 21 26 26 21 26 26 21 26 21 26 21 26 26 26 21 21 26 21 26 21 26 26 21 21 26 26 26 21 21 26 21 26 21 21 26 26 21 21 21 21 26 21 26
21 21 21 21 21 26 26 21 26 26 21 26 26 21 21 21 26 21 26 26 26 21 26 26 21 26 21 26 26 21 21 26 26 26 21 21 21 26 21 26 21 26 26 21 21 21 26 21 21 26
21 21 21 21 21 26 26 21 26 26 21 26 26 21 26 21 26 21 26 26 26 21 21 26 21 26 21 26 26 21 21 26 26 26 21 21 26 21 26 21 21 26 26 21 21 21 21 26 21 26
21 21 21 21 21 26 26 21 26 26 21 26 26 21 26 21 26 21 26 26 26 21 21 26 21 26 21 26 26 21 21 26 26 26 21 21 26 21 26 21 21 26 26 21 21 21 21 26 21 26
21 21 21 21 21 26 26 21 24 24 24 24 24 24 24 24 24 24 24 24 24 24 24 24 24 24 24 24 24 24 24 24 24 24 24 24 24 24 24 24 24 24 21 21 21 21 21 26 21 26
26 21 26 26 26 21 21 22 27 12 12 12 12 10 10 10 10 10 10 10 10 10 10 10 10 10 10 10 10 10 10 10 10 10 10 10 10 10 10 10 10 28 20 21 21 26 21 26 26 21
26 21 26 26 26 21 21 22 12 12 10 12 11 10 10 10 10 10 10 11 10 10 12 10 10 10 11 10 10 10 10 10 10 10 10 10 10 10 10 10 10 10 20 21 21 26 21 26 26 21
26 21 26 26 26 21 21 22 12 12 12 11 10 12 10 10 10 10 10 10 11 10 10 10 10 12 10 10 12 10 10 10 10 10 10 10 10 10 10 10 10 10 20 21 21 26 21 26 26 21
26 21 26 26 26 21 21 22 10 11 12 12 12 10 12 10 10 10 10 10 10 10 10 11 10 10 10 10 10 10 10 10 10 10 10 10 10 10 10 10 10 10 20 21 21 26 21 26 26 21
26 21 26 26 26 21 21 22 10 10 11 10 12 10 12 10 10 10 10 10 10 10 10 10 14 14 14 14 14 10 10 10 10 10 10 10 10 10 10 10 10 10 20 21 21 26 21 26 26 21
26 21 26 26 26 21 21 22 12 12 10 11 12 12 12 10 10 10 15 10 10 10 10 10 14 13 13 13 14 10 10 10 10 10 10 10 10 10 10 10 10 10 20 21 21 26 21 26 26 21
26 21 26 26 26 21 21 22 10 12 12 10 12 12 12 10 15 16 16 10 10 10 10 10 14 13 13 13 14 10 10 10 10 10 10 10 10 10 10 10 10 10 20 21 21 26 21 26 26 21
26 21 26 26 26 21 21 22 11 10 10 12 10 12 12 16 16 16 15 10 10 10 10 10 14 13 13 13 14 10 10 10 10 10 10 10 10 10 10 10 10 10 20 21 21 26 21 26 26 21
26 21 26 26 26 21 21 22 12 12 10 11 11 11 15 16 16 15 11 10 10 10 10 10 14 14 13 14 14 10 10 10 10 10 10 10 10 10 10 10 10 10 20 21 21 26 21 26 26 21
26 21 26 26 26 21 21 22 12 12 11 10 10 12 15 15 12 10 10 10 10 10 10 10 10 10 31 34 10 10 10 10 10 10 10 10 10 10 10 10 10 10 20 21 21 26 21 26 26 21
26 21 26 26 26 21 21 22 10 12 10 12 10 10 10 11 10 10 10 10 10 10 10 10 10 10 31 34 10 10 10 10 10 10 10 10 10 10 10 10 10 10 20 21 21 26 21 26 26 21
26 21 26 26 26 21 21 22 10 10 10 10 10 12 10 10 10 10 10 10 10 10 10 10 10 10 31 34 10 10 10 10 10 10 10 10 10 10 10 10 10 10 20 21 21 26 21 26 26 21
26 21 26 26 26 21 21 22 10 10 10 10 10 10 11 10 10 10 10 10 10 10 10 10 10 10 31 34 10 10 10 10 10 10 10 10 10 10 10 10 10 10 20 21 21 26 21 26 26 21
26 21 26 26 26 21 21 22 10 10 10 10 10 10 10 10 10 10 10 10 10 10 38 32 32 43 31 34 10 10 10 10 10 10 10 10 10 10 10 10 10 10 20 21 21 26 21 26 26 21
26 21 26 26 26 21 21 22 10 10 10 10 10 10 10 10 10 10 10 10 10 10 10 31 31 31 31 34 10 10 10 10 10 10 10 10 10 10 10 10 10 10 20 21 21 26 21 26 26 21
26 21 26 26 26 21 21 22 10 10 10 10 10 10 10 10 10 10 10 10 10 10 10 31 40 35 35 36 10 10 10 10 10 10 10 10 10 10 10 10 10 10 20 21 21 26 21 26 26 21
26 21 26 26 26 21 21 22 10 10 10 10 10 10 10 10 10 10 10 10 10 10 10 31 42 32 32 32 32 32 32 32 10 10 10 10 10 10 10 10 10 10 20 21 21 26 21 26 26 21
26 21 26 26 26 21 21 22 10 10 10 10 10 10 10 10 10 10 10 10 10 10 10 31 31 31 31 31 31 31 31 31 10 10 10 10 10 10 10 10 10 10 20 21 21 26 21 26 26 21
26 21 26 26 26 21 21 22 10 10 10 10 10 10 10 10 10 10 10 10 10 10 10 10 10 10 10 10 10 10 10 10 10 10 10 10 10 10 10 10 10 10 20 21 21 26 21 26 26 21
26 21 26 26 26 21 21 22 10 10 10 10 10 10 10 10 10 10 10 10 10 10 10 10 10 10 10 10 10 10 10 10 10 10 10 10 10 10 10 10 10 10 20 21 21 26 21 26 26 21
26 21 26 26 26 21 21 22 10 10 10 10 10 10 10 10 10 10 10 10 10 10 10 10 10 10 10 10 10 10 10 10 10 10 10 10 10 10 10 10 10 10 20 21 21 26 21 26 26 21
26 21 26 26 26 21 21 22 10 10 10 10 10 10 10 10 10 10 10 10 10 10 10 10 10 10 10 10 10 10 10 10 10 10 10 10 10 10 10 10 10 10 20 21 21 26 21 26 26 21
26 21 26 26 26 21 21 22 10 10 10 10 10 10 10 10 10 10 10 10 10 10 10 10 10 10 10 10 10 10 10 10 10 10 10 10 10 10 10 10 10 10 20 21 21 26 21 26 26 21
26 21 26 26 26 21 21 22 10 10 10 10 10 10 10 10 10 10 10 10 10 10 10 10 10 10 10 10 10 10 10 10 10 10 10 10 10 10 10 10 10 10 20 21 21 26 21 26 26 21
26 21 26 26 26 21 21 22 10 10 10 10 10 10 10 10 10 10 10 10 10 10 10 10 10 10 10 10 10 10 10 10 10 10 10 10 10 10 10 10 10 10 20 21 21 26 21 26 26 21
26 21 26 26 26 21 21 22 10 10 10 10 10 10 10 10 10 10 10 10 10 10 10 10 10 10 10 10 10 10 10 10 10 10 10 10 10 10 10 10 10 10 20 21 21 26 21 26 26 21
26 21 26 26 26 21 21 22 10 10 10 10 10 10 10 10 10 10 10 10 10 10 10 10 10 10 10 10 10 10 10 10 10 10 10 10 10 10 10 10 10 10 20 21 21 26 21 26 26 21
26 21 26 26 26 21 21 22 21 10 10 10 10 10 10 10 10 10 10 10 10 10 10 10 10 10 10 10 10 10 10 10 10 10 10 10 10 10 10 10 10 10 20 21 21 26 21 26 26 21
26 21 26 26 26 21 21 22 10 10 10 10 10 10 10 10 10 10 10 10 10 10 10 10 10 10 10 10 10 10 10 10 10 10 10 10 10 10 10 10 10 10 20 21 21 26 21 26 26 21
26 21 26 26 26 21 21 22 10 10 10 10 10 10 10 10 10 10 10 10 10 10 10 10 10 10 10 10 10 10 10 10 10 10 10 10 10 10 10 10 10 10 20 21 21 26 21 26 26 21
26 21 26 26 26 21 21 22 10 10 10 10 10 10 10 10 10 10 10 10 10 10 10 10 10 10 10 10 10 10 10 10 10 10 10 10 10 10 10 10 10 10 20 21 21 26 21 26 26 21
26 21 26 26 26 21 21 22 10 10 10 10 10 10 10 10 10 10 10 10 10 10 10 10 10 10 10 10 10 10 10 10 10 10 10 10 10 10 10 10 10 10 20 21 21 26 21 26 26 21
26 21 26 26 26 21 21 22 10 10 10 10 10 10 10 10 10 10 10 10 10 10 10 10 10 10 10 10 10 10 10 10 10 10 10 10 10 10 10 10 10 10 20 21 21 26 21 26 26 21
26 21 26 26 26 21 21 22 10 10 10 10 10 10 10 10 10 10 10 10 10 10 10 10 10 10 10 10 10 10 10 10 10 10 10 10 10 10 10 10 10 10 20 21 21 26 21 26 26 21
26 21 26 26 26 21 21 22 10 10 10 10 10 10 10 10 10 10 10 10 10 10 10 10 10 10 10 10 10 10 10 10 10 10 10 10 10 10 10 10 10 10 20 21 21 26 21 26 26 21
26 21 26 26 26 21 21 22 10 10 10 10 10 10 10 10 10 10 10 10 10 10 10 10 10 10 10 10 10 10 10 10 10 10 10 10 10 10 10 10 10 10 20 21 21 26 21 26 26 21
26 21 26 26 26 21 21 22 10 10 10 10 10 10 10 10 10 10 10 10 10 10 10 10 10 10 10 10 10 10 10 10 10 10 10 10 10 10 10 10 10 10 20 21 21 26 21 26 26 21
26 21 26 26 26 21 21 22 29 10 10 10 10 10 10 10 10 10 10 10 10 10 10 10 10 10 10 10 10 10 10 10 10 10 10 10 10 10 10 10 10 30 20 21 21 26 21 26 26 21
21 21 21 21 21 26 26 21 18 18 18 18 18 18 18 18 18 18 18 18 18 18 18 18 18 18 18 18 18 18 18 18 18 18 18 18 18 18 18 18 18 26 26 21 21 21 21 26 21 26
21 21 21 21 21 26 26 21 26 26 21 26 26 21 26 21 26 21 26 26 26 21 21 26 21 26 21 26 26 21 21 26 26 26 21 21 26 21 26 21 21 26 26 21 21 21 21 26 21 26
21 21 21 21 21 26 26 26 26 26 21 26 26 21 26 26 26 21 26 26 26 21 26 26 26 26 21 26 26 21 21 26 26 26 21 21 21 21 21 21 21 26 26 21 21 21 21 21 21 26
21 21 21 21 21 26 26 21 26 26 21 26 26 21 26 21 26 21 26 26 26 21 21 26 21 26 21 26 26 21 21 26 26 26 21 21 26 21 26 21 21 26 26 21 21 21 21 26 21 26
21 21 21 21 21 26 26 21 26 26 21 26 26 21 21 21 26 21 26 26 26 21 26 26 21 26 21 26 26 21 21 26 26 26 21 21 21 26 21 26 21 26 26 21 21 21 26 21 21 26
21 21 21 21 21 26 26 21 26 26 21 26 26 21 26 21 26 21 26 26 26 21 21 26 21 26 21 26 26 21 21 26 26 26 21 21 26 21 26 21 21 26 26 21 21 21 21 26 21 26