21 21 21 21 21 26 26 26 26 26 21 26 26 21 26 26 26 21 26 26 26 21 26 26 26 26 21 26 26 21 21 26 26 26 21 21 21 21 21 21 21 26 26 21 21 21 21 21 21 26
21 21 21 21 21 26 26 21 26 26 21 26 26 21 26 21 26 21 26 26 26 21 21 26 21 26 21 26 26 21 21 26 26 26 21 21 26 21 26 21 21 26 26 21 21 21 21 26 21 26
21 21 21 21 21 26 26 21 26 26 21 26 26 21 21 21 26 21 26 26 26 21 26 26 21 26 21 26 26 21 21 26 26 26 21 21 21 26 21 26 21 26 26 21 21 21 26 21 21 26
21 21 21 21 21 26 26 21 26 26 21 26 26 21 26 21 26 21 26 26 26 21 21 26 21 26 21 26 26 21 21 26 26 26 21 21 26 21 26 21 21 26 26 21 21 21 21 26 21 26
21 21 21 21 21 26 26 21 26 26 21 26 26 21 26 21 26 21 26 26 26 21 21 26 21 26 21 26 26 21 21 26 26 26 21 21 26 21 21 21 21 21 21 21 21 21 21 26 21 26
21 21 21 21 21 26 26 21 24 24 24 24 24 24 24 24 24 24 24 24 24 24 21 21 21 24 24 24 24 24 24 24 24 24 24 21 21 21 21 21 21 21 21 21 21 21 21 26 21 26
26 21 26 26 26 21 21 22 10 12 12 12 12 10 10 10 10 10 10 10 10 10 23 21 21 12 78 12 12 10 10 10 10 10 10 20 21 21 21 21 21 21 21 21 21 26 21 26 26 21
26 21 26 26 26 21 21 21 19 12 11 12 11 10 10 10 10 10 10 11 10 10 11 23 21 78 78 12 10 10 10 10 10 10 10 23 24 24 21 21 21 21 21 21 21 26 21 26 26 21
26 21 26 26 26 21 21 21 24 19 12 11 10 12 10 10 10 16 10 10 10 11 10 11 20 12 12 11 10 10 10 10 10 10 10 10 10 10 23 24 24 21 21 21 21 26 21 26 26 21
26 21 26 26 26 21 21 22 11 23 19 12 12 10 12 10 10 10 10 10 11 15 11 10 20 10 10 10 10 10 10 10 10 10 10 10 10 10 10 10 10 23 21 21 21 26 21 26 26 21
26 21 26 26 26 21 21 22 10 11 23 19 12 11 12 10 10 10 10 10 11 16 11 10 20 10 10 10 10 10 10 10 10 10 10 10 10 10 10 10 10 10 20 21 21 26 21 26 26 21
26 21 26 26 26 21 21 22 10 10 11 23 19 12 12 10 10 10 15 10 16 11 10 10 20 10 10 10 10 10 10 10 10 16 15 16 10 15 10 10 10 10 20 21 21 26 21 26 26 21
26 21 26 26 26 21 21 22 10 10 10 11 23 19 12 10 15 16 16 10 15 10 10 10 20 10 10 10 10 10 10 10 15 16 15 15 16 16 16 10 10 10 20 21 21 26 21 26 26 21
26 21 26 26 26 21 21 22 11 10 10 10 11 23 19 11 11 16 15 77 15 10 10 10 23 10 10 10 10 10 10 15 15 10 10 40 38 41 15 15 10 10 20 21 21 26 21 26 26 21
26 21 26 26 26 21 21 22 10 10 10 10 10 11 23 19 11 15 11 10 16 10 10 10 10 10 10 10 10 10 10 10 15 16 15 36 35 34 16 15 10 10 20 21 21 26 21 26 26 21
26 21 26 26 26 21 21 22 10 10 11 10 10 11 11 11 11 10 10 78 10 15 16 10 17 10 10 10 10 10 10 10 10 15 16 36 35 34 15 10 10 10 20 21 21 26 21 26 26 21
26 21 26 26 26 21 21 22 10 10 10 15 10 10 11 11 10 11 15 10 10 10 15 15 20 10 10 10 10 10 10 10 10 10 10 36 35 34 10 10 10 10 20 21 21 26 21 26 26 21
26 21 26 26 26 21 21 22 10 10 10 10 10 12 10 11 11 15 11 10 77 10 10 10 20 10 10 10 10 10 10 10 10 10 10 36 35 34 10 10 10 10 20 21 21 26 21 26 26 21
26 21 26 26 26 21 21 22 10 10 10 10 10 10 11 15 15 11 10 10 10 10 17 18 25 10 10 10 10 10 10 10 10 10 10 36 35 34 10 10 10 10 20 21 21 26 21 26 26 21
26 21 26 26 26 21 21 22 10 10 10 10 10 11 15 11 11 78 10 10 10 10 20 10 15 10 10 10 10 10 10 10 10 10 10 36 35 34 10 10 10 10 20 21 21 26 21 26 26 21
26 21 26 26 26 21 21 22 10 10 10 10 10 10 77 10 10 10 15 10 10 17 24 15 15 15 16 10 10 10 10 10 10 10 10 36 35 34 10 10 10 10 20 21 21 26 21 26 26 21
26 21 26 26 26 21 21 22 10 10 10 10 76 77 10 78 10 16 10 78 17 25 15 15 15 16 16 15 10 10 10 10 10 10 10 36 35 34 10 10 10 10 20 21 21 26 21 26 26 21
26 21 26 26 26 21 21 21 19 10 10 11 10 78 10 10 78 10 78 17 25 15 16 44 45 46 47 15 16 10 10 10 10 10 10 36 35 34 10 10 10 10 20 21 21 26 21 26 26 21
26 21 26 26 26 21 21 21 21 18 18 19 10 17 18 18 18 18 18 25 16 16 16 48 49 50 51 40 38 38 38 38 38 38 38 39 35 34 10 10 10 10 20 21 21 26 21 26 26 21
26 21 26 26 26 21 21 21 24 25 10 10 10 10 10 10 10 10 11 16 16 15 16 52 53 54 55 36 35 35 35 35 35 35 35 35 35 34 10 10 10 10 20 21 21 26 21 26 26 21
26 21 26 26 26 21 21 22 10 10 10 10 10 10 10 10 10 10 10 11 15 15 16 56 57 58 59 42 32 32 32 32 32 32 32 32 32 43 10 10 10 10 20 21 21 26 21 26 26 21
26 21 26 26 26 21 21 22 10 10 10 10 10 10 10 10 10 10 10 10 11 15 15 15 16 15 16 16 15 10 10 10 10 10 10 10 10 10 15 10 15 16 20 21 21 26 21 26 26 21
26 21 26 26 26 21 21 22 10 10 10 10 10 10 10 10 10 10 10 10 10 11 16 15 15 15 15 15 15 16 15 15 15 16 16 15 15 16 16 15 15 15 20 21 21 26 21 26 26 21
26 21 26 26 26 21 21 22 10 10 10 10 10 10 10 10 10 10 10 10 11 15 11 16 16 11 15 15 15 15 15 15 15 16 16 16 16 16 16 16 16 15 20 21 21 26 21 26 26 21
26 21 26 26 26 21 21 22 10 77 10 10 10 10 10 10 10 10 10 11 16 11 10 17 18 18 18 19 11 16 16 16 16 10 10 16 16 16 10 15 10 16 20 21 21 26 21 26 26 21
26 21 26 26 26 21 21 22 10 10 10 10 10 10 10 10 11 11 11 16 11 10 10 23 21 21 21 22 76 10 10 10 10 10 10 10 16 10 10 76 10 77 20 21 21 26 21 26 26 21
26 21 26 26 26 21 21 22 10 10 10 10 10 10 10 10 11 15 15 11 10 10 10 10 23 21 21 25 76 10 10 15 10 10 10 10 77 10 78 10 10 77 20 21 21 26 21 26 26 21
26 21 26 26 26 21 21 22 10 10 10 10 10 10 10 10 11 15 11 10 10 10 10 10 10 23 22 10 77 10 10 76 10 10 10 10 76 10 12 77 10 76 20 21 21 26 21 26 26 21
26 21 26 26 26 21 21 22 10 10 10 10 10 10 10 11 15 11 10 10 10 10 10 10 10 10 20 10 10 77 10 76 10 10 10 10 76 10 76 10 10 12 20 21 21 26 21 26 26 21
26 21 26 26 26 21 21 22 16 10 10 10 10 10 11 15 11 10 10 10 10 10 10 10 10 10 23 10 10 76 10 76 10 10 10 77 10 10 77 78 10 77 20 21 21 26 21 26 26 21
26 21 26 26 26 21 21 22 10 10 10 10 10 11 16 11 10 10 10 10 10 10 10 10 10 10 10 10 10 77 10 76 10 10 10 76 10 11 77 10 10 77 20 21 21 26 21 26 26 21
26 21 26 26 26 21 21 22 16 10 10 10 11 16 11 10 10 10 10 10 10 10 10 10 10 10 17 10 76 10 10 77 10 10 77 10 10 77 76 10 10 11 20 21 21 26 21 26 26 21
26 21 26 26 26 21 21 22 16 10 11 15 16 11 10 10 10 10 10 10 10 10 10 10 10 17 25 10 10 77 10 76 10 10 76 10 10 10 76 10 78 77 20 21 21 26 21 26 26 21
26 21 26 26 26 21 21 22 10 10 11 15 11 10 10 10 10 10 10 11 10 77 10 10 17 25 10 10 76 10 10 76 10 10 76 10 78 77 77 10 10 76 20 21 21 26 21 26 26 21
26 21 26 26 26 21 21 22 11 10 10 11 10 10 10 10 10 10 11 15 16 76 77 10 20 10 10 10 76 10 10 77 10 10 76 10 77 10 76 78 10 76 20 21 21 26 21 26 26 21
26 21 26 26 26 21 21 22 15 11 78 10 10 10 10 10 10 11 15 79 80 81 82 10 20 10 10 10 76 10 10 77 10 10 77 10 76 77 60 61 62 63 23 21 21 26 21 26 26 21
26 21 26 26 26 21 21 22 15 11 10 10 10 10 10 10 10 16 16 83 84 85 86 10 20 10 10 10 10 78 10 77 10 10 76 10 10 76 64 65 66 67 76 20 21 26 21 26 26 21
26 21 26 26 26 21 21 28 19 15 11 10 10 10 10 10 76 76 77 87 88 89 90 10 20 10 10 16 10 10 10 77 10 10 10 10 77 76 68 69 70 71 10 20 21 26 21 26 26 21
26 21 26 26 26 21 21 21 28 19 10 10 10 10 10 78 78 78 78 91 92 93 94 17 22 10 10 15 10 10 10 15 10 78 76 10 77 76 72 73 74 75 10 20 21 26 21 26 26 21
21 21 21 21 21 26 26 21 21 28 18 18 18 18 18 18 18 18 18 18 18 18 18 29 28 18 18 18 18 18 18 18 18 18 18 18 19 10 10 10 10 10 10 20 21 21 21 26 21 26
21 21 21 21 21 26 26 21 26 26 21 26 26 21 26 21 26 21 26 26 26 21 21 26 21 26 21 26 26 21 21 26 26 26 21 21 28 19 77 10 10 10 77 20 21 21 21 26 21 26
21 21 21 21 21 26 26 26 26 26 21 26 26 21 26 26 26 21 26 26 26 21 26 26 26 26 21 26 26 21 21 26 26 26 21 21 21 28 18 18 18 18 18 29 21 21 21 21 21 26
21 21 21 21 21 26 26 21 26 26 21 26 26 21 26 21 26 21 26 26 26 21 21 26 21 26 21 26 26 21 21 26 26 26 21 21 26 21 26 21 21 21 26 21 21 21 21 26 21 26
21 21 21 21 21 26 26 21 26 26 21 26 26 21 21 21 26 21 26 26 26 21 26 26 21 26 21 26 26 21 21 26 26 26 21 21 21 26 21 26 21 26 26 21 21 21 26 21 21 26
21 21 21 21 21 26 26 21 26 26 21 26 26 21 26 21 26 21 26 26 26 21 21 26 21 26 21 26 26 21 21 26 26 26 21 21 26 21 26 21 21 26 26 21 21 21 21 26 21 26