21 21 21 21 21 26 26 26 26 26 21 26 26 21 26 26 26 21 26 26 26 21 26 26 26 26 21 26 26 21 21 26 26 26 21 21 21 21 21 21 21 26 26 21 21 21 21 21 21 26
21 21 21 21 21 26 26 21 26 26 21 26 26 21 26 21 26 21 26 26 26 21 21 26 21 26 21 26 26 21 21 26 26 26 21 21 26 21 26 21 21 26 26 21 21 21 21 26 21 26
21 21 21 21 21 26 26 21 26 26 21 26 26 21 21 21 26 21 26 26 26 21 26 26 21 26 21 26 26 21 21 26 26 26 21 21 21 26 21 26 21 26 26 21 21 21 26 21 21 26
21 21 21 21 21 26 26 21 26 26 21 26 26 21 26 21 26 21 26 26 26 21 21 26 21 26 21 26 26 21 21 26 26 26 21 21 26 21 26 21 21 26 26 21 21 21 21 26 21 26
21 21 21 21 21 26 26 21 26 26 21 26 26 21 26 21 26 21 26 26 26 21 21 26 21 26 21 26 26 21 21 26 26 26 21 21 26 21 21 21 21 21 21 21 21 21 21 26 21 26
21 21 21 21 21 26 26 21 24 24 24 24 24 24 24 24 24 24 24 24 24 24 24 24 21 24 24 24 24 24 24 24 24 24 24 21 21 21 21 21 21 21 21 21 21 21 21 26 21 26
26 21 26 26 26 21 21 22 10 12 12 12 12 10 10 10 10 10 10 10 10 10 10 10 21 10 10 10 10 10 10 10 10 10 10 20 21 21 21 21 21 21 21 21 21 26 21 26 26 21
26 21 26 26 26 21 21 22 12 12 10 12 11 10 10 10 10 10 10 11 10 10 12 10 21 10 11 10 10 10 10 10 10 10 10 23 24 24 21 21 21 21 21 21 21 26 21 26 26 21
26 21 26 26 26 21 21 22 12 12 12 11 10 12 10 10 10 10 10 10 11 10 10 10 21 12 10 10 12 10 10 10 10 10 10 10 10 10 23 24 24 21 21 21 21 26 21 26 26 21
26 21 26 26 26 21 21 22 10 11 12 12 12 10 12 10 10 10 10 10 10 10 10 11 21 10 10 10 10 10 10 10 10 10 10 10 10 10 10 10 10 23 21 21 21 26 21 26 26 21
26 21 26 26 26 21 21 22 10 10 11 10 12 10 12 10 10 10 10 10 10 10 10 10 21 10 10 10 10 10 10 10 10 10 10 10 10 10 10 10 10 10 20 21 21 26 21 26 26 21
26 21 26 26 26 21 21 22 12 12 10 11 12 12 12 10 10 10 15 10 10 10 10 10 21 10 10 10 10 10 10 10 10 10 10 10 10 10 10 10 10 10 20 21 21 26 21 26 26 21
26 21 26 26 26 21 21 22 10 12 12 10 12 12 12 10 15 16 16 10 10 10 10 10 21 10 10 10 10 10 10 10 10 10 10 10 10 10 10 10 10 10 20 21 21 26 21 26 26 21
26 21 26 26 26 21 21 22 11 10 10 12 10 12 12 16 16 16 15 10 10 10 10 10 10 10 10 10 10 10 10 10 10 10 10 10 10 10 10 10 10 10 20 21 21 26 21 26 26 21
26 21 26 26 26 21 21 22 12 12 10 11 11 11 15 16 16 15 11 10 10 10 10 10 10 10 10 10 10 10 10 10 10 10 10 10 10 10 10 10 10 10 20 21 21 26 21 26 26 21
26 21 26 26 26 21 21 22 12 12 11 10 10 12 15 15 12 10 10 10 10 10 10 10 21 10 10 10 10 10 10 10 10 10 10 10 10 10 10 10 10 10 20 21 21 26 21 26 26 21
26 21 26 26 26 21 21 22 10 12 10 12 10 10 10 11 10 10 10 10 10 10 10 10 21 10 10 10 10 10 10 10 10 10 10 10 10 10 10 10 10 10 20 21 21 26 21 26 26 21
26 21 26 26 26 21 21 22 10 10 10 10 10 12 10 10 10 10 10 10 10 10 10 10 21 10 10 10 10 10 10 10 10 10 10 10 10 10 10 10 10 10 20 21 21 26 21 26 26 21
26 21 26 26 26 21 21 22 10 10 10 10 10 10 11 10 10 10 10 10 10 10 21 21 21 10 10 10 10 10 10 10 10 10 10 10 10 10 10 10 10 10 20 21 21 26 21 26 26 21
26 21 26 26 26 21 21 22 10 10 10 10 10 10 10 10 10 10 10 10 10 10 21 10 15 10 10 10 10 10 10 10 10 10 10 10 10 10 10 10 10 10 20 21 21 26 21 26 26 21
26 21 26 26 26 21 21 22 10 10 10 10 10 10 10 10 10 10 10 10 10 21 21 15 15 15 16 10 10 10 10 10 10 10 10 10 10 10 10 10 10 10 20 21 21 26 21 26 26 21
26 21 26 26 26 21 21 22 10 10 10 10 10 10 10 10 10 10 10 10 21 21 15 15 15 16 16 15 10 10 10 10 10 10 10 10 10 10 10 10 10 10 20 21 21 26 21 26 26 21
26 21 26 26 26 21 21 22 10 10 10 10 10 10 10 10 10 10 10 21 21 15 16 44 45 46 47 15 10 10 10 10 10 10 10 10 10 10 10 10 10 10 20 21 21 26 21 26 26 21
26 21 26 26 26 21 21 21 21 21 21 10 10 21 21 21 21 21 21 21 16 16 16 48 49 50 51 40 38 38 38 38 38 10 10 10 10 10 10 10 10 10 20 21 21 26 21 26 26 21
26 21 26 26 26 21 21 22 10 10 10 10 10 10 10 10 10 10 10 16 16 15 16 52 53 54 55 36 35 35 35 35 35 35 35 35 35 10 10 10 10 10 20 21 21 26 21 26 26 21
26 21 26 26 26 21 21 22 10 10 10 10 10 10 10 10 10 10 10 10 15 15 16 56 57 58 59 42 32 32 32 32 32 10 10 10 10 10 10 10 10 10 20 21 21 26 21 26 26 21
26 21 26 26 26 21 21 22 10 10 10 10 10 10 10 10 10 10 10 10 10 15 15 15 16 15 16 16 15 10 10 10 10 10 10 10 10 10 15 10 15 16 20 21 21 26 21 26 26 21
26 21 26 26 26 21 21 22 10 10 10 10 10 10 10 10 10 10 10 10 10 10 16 15 15 15 15 15 15 16 15 15 15 16 16 15 15 16 16 15 15 15 20 21 21 26 21 26 26 21
26 21 26 26 26 21 21 22 10 10 10 10 10 10 10 10 10 10 10 10 10 10 10 16 16 10 10 15 15 15 15 15 15 16 16 16 16 16 16 16 16 15 20 21 21 26 21 26 26 21
26 21 26 26 26 21 21 22 10 10 10 10 10 10 10 10 10 10 10 10 10 10 10 10 10 10 10 10 10 16 16 16 16 10 10 16 16 16 10 15 10 16 20 21 21 26 21 26 26 21
26 21 26 26 26 21 21 22 10 10 10 10 10 10 10 10 10 10 10 10 10 10 10 10 10 10 10 10 10 10 10 10 10 10 10 10 10 10 10 10 10 10 20 21 21 26 21 26 26 21
26 21 26 26 26 21 21 22 10 10 10 10 10 10 10 10 10 10 10 10 10 10 10 10 10 10 10 10 10 10 10 10 10 10 10 10 10 10 10 10 10 10 20 21 21 26 21 26 26 21
26 21 26 26 26 21 21 22 10 10 10 10 10 10 10 10 10 10 10 10 10 10 10 10 10 10 10 10 10 10 10 10 10 10 10 10 10 10 10 10 10 10 20 21 21 26 21 26 26 21
26 21 26 26 26 21 21 22 10 10 10 10 10 10 10 10 10 10 10 10 10 10 10 10 10 10 10 10 10 10 10 10 10 10 10 10 10 10 10 10 10 10 20 21 21 26 21 26 26 21
26 21 26 26 26 21 21 22 10 10 10 10 10 10 10 10 10 10 10 10 10 10 10 10 10 10 10 10 10 10 10 10 10 10 10 10 10 10 10 10 10 10 20 21 21 26 21 26 26 21
26 21 26 26 26 21 21 22 10 10 10 10 10 10 10 10 10 10 10 10 10 10 10 10 10 10 10 10 10 10 10 10 10 10 10 10 10 10 10 10 10 10 20 21 21 26 21 26 26 21
26 21 26 26 26 21 21 22 10 10 10 10 10 10 10 10 10 10 10 10 10 10 10 10 10 10 10 10 10 10 10 10 10 10 10 10 10 10 10 10 10 10 20 21 21 26 21 26 26 21
26 21 26 26 26 21 21 22 10 10 10 10 10 10 10 10 10 10 10 10 10 10 10 10 10 10 10 10 10 10 10 10 10 10 10 10 10 10 10 10 10 10 20 21 21 26 21 26 26 21
26 21 26 26 26 21 21 22 10 10 10 10 10 10 10 10 10 10 10 10 10 10 10 10 10 10 10 10 10 10 10 10 10 10 10 10 10 10 10 10 10 10 20 21 21 26 21 26 26 21
26 21 26 26 26 21 21 22 10 10 10 10 10 10 10 10 10 10 10 10 10 10 10 10 10 10 10 10 10 10 10 10 10 10 10 10 10 10 10 10 10 10 20 21 21 26 21 26 26 21
26 21 26 26 26 21 21 22 10 10 10 10 10 10 10 10 10 10 10 10 10 10 10 10 10 10 10 10 10 10 10 10 10 10 10 10 10 10 10 10 10 10 20 21 21 26 21 26 26 21
26 21 26 26 26 21 21 22 10 10 10 10 10 10 10 10 10 10 10 10 10 10 10 10 10 10 10 10 10 10 10 10 10 10 10 10 10 10 10 10 10 10 20 21 21 26 21 26 26 21
26 21 26 26 26 21 21 22 10 10 10 10 10 10 10 10 10 10 10 10 10 10 10 10 10 10 10 10 10 10 10 10 10 10 10 10 10 10 10 10 10 10 20 21 21 26 21 26 26 21
26 21 26 26 26 21 21 22 10 10 10 10 10 10 10 10 10 10 10 10 10 10 10 10 10 10 10 10 10 10 10 10 10 10 10 10 10 10 10 10 10 10 20 21 21 26 21 26 26 21
21 21 21 21 21 26 26 28 18 18 18 18 18 18 18 18 18 18 18 18 18 18 18 18 18 18 18 18 18 18 18 18 18 18 18 18 18 18 18 18 18 18 29 21 21 21 21 26 21 26
21 21 21 21 21 26 26 21 26 26 21 26 26 21 26 21 26 21 26 26 26 21 21 26 21 26 21 26 26 21 21 26 26 26 21 21 26 21 26 21 21 26 26 21 21 21 21 26 21 26
21 21 21 21 21 26 26 26 26 26 21 26 26 21 26 26 26 21 26 26 26 21 26 26 26 26 21 26 26 21 21 26 26 26 21 21 21 21 21 21 21 26 26 21 21 21 21 21 21 26
21 21 21 21 21 26 26 21 26 26 21 26 26 21 26 21 26 21 26 26 26 21 21 26 21 26 21 26 26 21 21 26 26 26 21 21 26 21 26 21 21 26 26 21 21 21 21 26 21 26
21 21 21 21 21 26 26 21 26 26 21 26 26 21 21 21 26 21 26 26 26 21 26 26 21 26 21 26 26 21 21 26 26 26 21 21 21 26 21 26 21 26 26 21 21 21 26 21 21 26
21 21 21 21 21 26 26 21 26 26 21 26 26 21 26 21 26 21 26 26 26 21 21 26 21 26 21 26 26 21 21 26 26 26 21 21 26 21 26 21 21 26 26 21 21 21 21 26 21 26