21 21 21 21 21 26 26 26 26 26 21 26 26 21 26 26 26 21 26 26 26 21 26 26 26 26 21 26 26 21 21 26 26 26 21 21 21 21 21 21 21 26 26 21 21 21 21 21 21 26
21 21 21 21 21 26 26 21 26 26 21 26 26 21 26 21 26 21 26 26 26 21 21 26 21 26 21 26 26 21 21 26 26 26 21 21 26 21 26 21 21 26 26 21 21 21 21 26 21 26
21 21 21 21 21 26 26 21 26 26 21 26 26 21 21 21 26 21 26 26 26 21 26 26 21 26 21 26 26 21 21 26 26 26 21 21 21 26 21 26 21 26 26 21 21 21 26 21 21 26
21 21 21 21 21 26 26 21 26 26 21 26 26 21 26 21 26 21 26 26 26 21 21 26 21 26 21 26 26 21 21 26 26 26 21 21 26 21 26 21 21 26 26 21 21 21 21 26 21 26
21 21 21 21 21 26 26 21 26 26 21 26 26 21 26 21 26 21 26 26 26 21 21 26 21 26 21 26 26 21 21 26 26 26 21 21 26 21 26 21 21 26 26 21 21 21 21 26 21 26
21 21 21 21 21 26 26 21 26 26 21 26 26 21 26 21 26 21 26 26 26 21 21 26 21 26 21 26 26 21 21 26 26 26 21 21 26 21 26 21 21 26 26 21 21 21 21 26 21 26
26 21 26 26 26 21 21 26 10 10 10 10 10 10 10 10 10 10 10 10 10 10 10 10 10 10 10 10 10 10 10 10 10 10 10 10 10 10 10 10 10 10 21 21 21 26 21 26 26 21
26 21 26 26 26 21 21 26 10 10 10 10 10 10 10 10 10 10 10 10 10 10 10 10 10 10 10 10 10 10 10 10 10 10 10 10 10 10 10 10 10 10 21 21 21 26 21 26 26 21
26 21 26 26 26 21 21 26 10 10 10 10 10 10 10 10 10 10 10 10 10 10 10 10 10 10 10 10 10 10 10 10 10 10 10 10 10 10 10 10 10 10 21 21 21 26 21 26 26 21
26 21 26 26 26 21 21 26 10 10 10 10 10 10 10 10 10 10 10 10 10 10 10 10 10 10 10 10 10 10 10 10 10 10 10 10 10 10 10 10 10 10 21 21 21 26 21 26 26 21
26 21 26 26 26 21 21 26 10 10 10 10 10 10 10 10 10 10 10 10 10 10 10 10 10 10 10 10 10 10 10 10 10 10 10 10 10 10 10 10 10 10 21 21 21 26 21 26 26 21
26 21 26 26 26 21 21 26 10 10 10 10 10 10 10 10 10 10 10 10 10 10 10 10 10 10 10 10 10 10 10 10 10 10 10 10 10 10 10 10 10 10 21 21 21 26 21 26 26 21
26 21 26 26 26 21 21 26 10 10 10 10 10 10 10 10 10 10 10 10 10 10 10 10 10 10 10 10 10 10 10 10 10 10 10 10 10 10 10 10 10 10 21 21 21 26 21 26 26 21
26 21 26 26 26 21 21 26 10 10 10 10 10 10 10 10 10 10 10 10 10 10 10 10 10 10 10 10 10 10 10 10 10 10 10 10 10 10 10 10 10 10 21 21 21 26 21 26 26 21
26 21 26 26 26 21 21 26 10 10 10 10 10 10 10 10 10 10 10 10 10 10 10 10 10 10 10 10 10 10 10 10 10 10 10 10 10 10 10 10 10 10 21 21 21 26 21 26 26 21
26 21 26 26 26 21 21 26 10 10 10 10 10 10 10 10 10 10 10 10 10 10 10 10 10 10 10 10 10 10 10 10 10 10 10 10 10 10 10 10 10 10 21 21 21 26 21 26 26 21
26 21 26 26 26 21 21 26 10 10 10 10 10 10 10 10 10 10 10 10 10 10 10 10 10 10 10 10 10 10 10 10 10 10 10 10 10 10 10 10 10 10 21 21 21 26 21 26 26 21
26 21 26 26 26 21 21 26 10 10 10 10 10 10 10 10 10 10 10 10 10 10 10 10 10 10 10 10 10 10 10 10 10 10 10 10 10 10 10 10 10 10 21 21 21 26 21 26 26 21
26 21 26 26 26 21 21 26 10 10 10 10 10 10 10 10 10 10 10 10 10 10 10 10 10 10 10 10 10 10 10 10 10 10 10 10 10 10 10 10 10 10 21 21 21 26 21 26 26 21
26 21 26 26 26 21 21 26 10 10 10 10 10 10 10 10 10 10 10 10 10 10 10 10 10 10 10 10 10 10 10 10 10 10 10 10 10 10 10 10 10 10 21 21 21 26 21 26 26 21
26 21 26 26 26 21 21 26 10 10 10 10 10 10 10 10 10 10 10 10 10 10 10 10 10 10 10 10 10 10 10 10 10 10 10 10 10 10 10 10 10 10 21 21 21 26 21 26 26 21
26 21 26 26 26 21 21 26 10 10 10 10 10 10 10 10 10 10 10 10 10 10 10 10 10 10 10 10 10 10 10 10 10 10 10 10 10 10 10 10 10 10 21 21 21 26 21 26 26 21
26 21 26 26 26 21 21 26 10 10 10 10 10 10 10 10 10 10 10 10 10 10 10 10 10 10 10 10 10 10 10 10 10 10 10 10 10 10 10 10 10 10 21 21 21 26 21 26 26 21
26 21 26 26 26 21 21 26 10 10 10 10 10 10 10 10 10 10 10 10 10 10 10 10 10 10 10 10 10 10 10 10 10 10 10 10 10 10 10 10 10 10 21 21 21 26 21 26 26 21
26 21 26 26 26 21 21 26 10 10 10 10 10 10 10 10 10 10 10 10 10 10 10 10 10 10 10 10 10 10 10 10 10 10 10 10 10 10 10 10 10 10 21 21 21 26 21 26 26 21
26 21 26 26 26 21 21 26 10 10 10 10 10 10 10 10 10 10 10 10 10 10 10 10 10 10 10 10 10 10 10 10 10 10 10 10 10 10 10 10 10 10 21 21 21 26 21 26 26 21
26 21 26 26 26 21 21 26 10 10 10 10 10 10 10 10 10 10 10 10 10 10 10 10 10 10 10 10 10 10 10 10 10 10 10 10 10 10 10 10 10 10 21 21 21 26 21 26 26 21
26 21 26 26 26 21 21 26 10 10 10 10 10 10 10 10 10 10 10 10 10 10 10 10 10 10 10 10 10 10 10 10 10 10 10 10 10 10 10 10 10 10 21 21 21 26 21 26 26 21
26 21 26 26 26 21 21 26 10 10 10 10 10 10 10 10 10 10 10 10 10 10 10 10 10 10 10 10 10 10 10 10 10 10 10 10 10 10 10 10 10 10 21 21 21 26 21 26 26 21
26 21 26 26 26 21 21 26 10 10 10 10 10 10 10 10 10 10 10 10 10 10 10 10 10 10 10 10 10 10 10 10 10 10 10 10 10 10 10 10 10 10 21 21 21 26 21 26 26 21
26 21 26 26 26 21 21 26 10 10 10 10 10 10 10 10 10 10 10 10 10 10 10 10 10 10 10 10 10 10 10 10 10 10 10 10 10 10 10 10 10 10 21 21 21 26 21 26 26 21
26 21 26 26 26 21 21 26 10 10 10 10 10 10 10 10 10 10 10 10 10 10 10 10 10 10 10 10 10 10 10 10 10 10 10 10 10 10 10 10 10 10 21 21 21 26 21 26 26 21
26 21 26 26 26 21 21 26 10 10 10 10 10 10 10 10 10 10 10 10 10 10 10 10 10 10 10 10 10 10 10 10 10 10 10 10 10 10 10 10 10 10 21 21 21 26 21 26 26 21
26 21 26 26 26 21 21 26 10 10 10 10 10 10 10 10 10 10 10 10 10 10 10 10 10 10 10 10 10 10 10 10 10 10 10 10 10 10 10 10 10 10 21 21 21 26 21 26 26 21
26 21 26 26 26 21 21 26 10 10 10 10 10 10 10 10 10 10 10 10 10 10 10 10 10 10 10 10 10 10 10 10 10 10 10 10 10 10 10 10 10 10 21 21 21 26 21 26 26 21
26 21 26 26 26 21 21 26 10 10 10 10 10 10 10 10 10 10 10 10 10 10 10 10 10 10 10 10 10 10 10 10 10 10 10 10 10 10 10 10 10 10 21 21 21 26 21 26 26 21
26 21 26 26 26 21 21 26 10 10 10 10 10 10 10 10 10 10 10 10 10 10 10 10 10 10 10 10 10 10 10 10 10 10 10 10 10 10 10 10 10 10 21 21 21 26 21 26 26 21
26 21 26 26 26 21 21 26 10 10 10 10 10 10 10 10 10 10 10 10 10 10 10 10 10 10 10 10 10 10 10 10 10 10 10 10 10 10 10 10 10 10 21 21 21 26 21 26 26 21
26 21 26 26 26 21 21 26 10 10 10 10 10 10 10 10 10 10 10 10 10 10 10 10 10 10 10 10 10 10 10 10 10 10 10 10 10 10 10 10 10 10 21 21 21 26 21 26 26 21
26 21 26 26 26 21 21 26 10 10 10 10 10 10 10 10 10 10 10 10 10 10 10 10 10 10 10 10 10 10 10 10 10 10 10 10 10 10 10 10 10 10 21 21 21 26 21 26 26 21
26 21 26 26 26 21 21 26 10 10 10 10 10 10 10 10 10 10 10 10 10 10 10 10 10 10 10 10 10 10 10 10 10 10 10 10 10 10 10 10 10 10 21 21 21 26 21 26 26 21
26 21 26 26 26 21 21 26 10 10 10 10 10 10 10 10 10 10 10 10 10 10 10 10 10 10 10 10 10 10 10 10 10 10 10 10 10 10 10 10 10 10 21 21 21 26 21 26 26 21
26 21 26 26 26 21 21 26 10 10 10 10 10 10 10 10 10 10 10 10 10 10 10 10 10 10 10 10 10 10 10 10 10 10 10 10 10 10 10 10 10 10 21 21 21 26 21 26 26 21
26 21 26 26 26 21 21 26 10 10 10 10 10 10 10 10 10 10 10 10 10 10 10 10 10 10 10 10 10 10 10 10 10 10 10 10 10 10 10 10 10 10 21 21 21 26 21 26 26 21
21 21 21 21 21 26 26 21 26 26 21 26 26 21 26 21 26 21 26 26 26 21 21 26 21 26 21 26 26 21 21 26 26 26 21 21 26 21 26 21 21 26 26 21 21 21 21 26 21 26
21 21 21 21 21 26 26 21 26 26 21 26 26 21 26 21 26 21 26 26 26 21 21 26 21 26 21 26 26 21 21 26 26 26 21 21 26 21 26 21 21 26 26 21 21 21 21 26 21 26
21 21 21 21 21 26 26 26 26 26 21 26 26 21 26 26 26 21 26 26 26 21 26 26 26 26 21 26 26 21 21 26 26 26 21 21 21 21 21 21 21 26 26 21 21 21 21 21 21 26
21 21 21 21 21 26 26 21 26 26 21 26 26 21 26 21 26 21 26 26 26 21 21 26 21 26 21 26 26 21 21 26 26 26 21 21 26 21 26 21 21 26 26 21 21 21 21 26 21 26
21 21 21 21 21 26 26 21 26 26 21 26 26 21 21 21 26 21 26 26 26 21 26 26 21 26 21 26 26 21 21 26 26 26 21 21 21 26 21 26 21 26 26 21 21 21 26 21 21 26
21 21 21 21 21 26 26 21 26 26 21 26 26 21 26 21 26 21 26 26 26 21 21 26 21 26 21 26 26 21 21 26 26 26 21 21 26 21 26 21 21 26 26 21 21 21 21 26 21 26