21 21 21 21 21 26 26 26 26 26 21 26 26 21 26 26 26 21 26 26 26 21 26 26 26 26 21 26 26 21 21 26 26 26 21 21 21 21 21 21 21 26 26 21 21 21 21 21 21 26
21 21 21 21 21 26 26 21 26 26 21 26 26 21 26 21 26 21 26 26 26 21 21 26 21 26 21 26 26 21 21 26 26 26 21 21 26 21 26 21 21 26 26 21 21 21 21 26 21 26
21 21 21 21 21 26 26 21 26 26 21 26 26 21 21 21 26 21 26 26 26 21 26 26 21 26 21 26 26 21 21 26 26 26 21 21 21 26 21 26 21 26 26 21 21 21 26 21 21 26
21 21 21 21 21 26 26 21 26 26 21 26 26 21 26 21 26 21 26 26 26 21 21 26 21 26 21 26 26 21 21 26 26 26 21 21 26 21 26 21 21 26 26 21 21 21 21 26 21 26
21 21 21 21 21 26 26 21 26 26 21 26 26 21 26 21 26 21 26 26 26 21 21 26 21 26 21 26 26 21 21 26 26 26 21 21 26 21 26 21 21 21 21 21 21 21 21 26 21 26
21 21 21 21 21 26 26 21 24 24 24 24 24 24 24 24 24 24 24 24 24 24 24 24 24 24 24 24 24 24 24 24 24 24 24 24 24 24 24 24 24 24 27 21 21 21 21 26 21 26
26 21 26 26 26 21 21 22 10 12 12 12 12 10 10 10 10 10 10 10 10 10 10 10 10 10 10 10 10 10 10 10 10 10 10 10 10 10 10 10 10 10 20 21 21 26 21 26 26 21
26 21 26 26 26 21 21 22 12 12 10 12 11 10 10 10 10 10 10 11 10 10 12 10 10 10 11 10 10 10 10 10 10 10 10 10 10 10 10 10 10 10 20 21 21 26 21 26 26 21
26 21 26 26 26 21 21 22 12 12 12 11 10 12 10 10 10 10 10 10 11 10 10 10 10 12 10 10 12 10 10 10 10 10 10 10 10 10 10 10 10 10 20 21 21 26 21 26 26 21
26 21 26 26 26 21 21 22 10 11 12 12 12 10 12 10 10 10 10 10 10 10 10 11 10 10 10 10 10 10 10 10 10 10 10 10 10 10 10 10 10 10 20 21 21 26 21 26 26 21
26 21 26 26 26 21 21 22 10 10 11 10 12 10 12 10 10 10 10 10 10 10 10 10 14 14 14 14 14 10 10 10 10 10 10 10 10 10 10 10 10 10 20 21 21 26 21 26 26 21
26 21 26 26 26 21 21 22 12 12 10 11 12 12 12 10 10 10 15 10 10 10 10 10 14 13 13 13 14 10 10 10 10 10 10 10 10 10 10 10 10 10 20 21 21 26 21 26 26 21
26 21 26 26 26 21 21 22 10 12 12 10 12 12 12 10 15 16 16 10 10 10 10 10 14 13 13 13 14 10 10 10 10 10 10 10 10 10 10 10 10 10 20 21 21 26 21 26 26 21
26 21 26 26 26 21 21 22 11 10 10 12 10 12 12 16 16 16 15 10 10 10 10 10 14 13 13 13 14 10 10 10 10 10 10 10 10 10 10 10 10 10 20 21 21 26 21 26 26 21
26 21 26 26 26 21 21 22 12 12 10 11 11 11 15 16 16 15 11 10 10 10 10 10 14 14 13 14 14 10 10 10 10 10 10 10 10 10 10 10 10 10 20 21 21 26 21 26 26 21
26 21 26 26 26 21 21 22 12 12 11 10 10 12 15 15 12 10 10 10 10 10 10 10 10 10 31 34 10 10 10 10 10 10 10 10 10 10 10 10 10 10 20 21 21 26 21 26 26 21
26 21 26 26 26 21 21 22 10 12 10 12 10 10 10 11 10 10 10 10 10 10 10 10 10 10 31 34 10 10 10 10 10 10 10 10 10 10 10 10 10 10 20 21 21 26 21 26 26 21
26 21 26 26 26 21 21 22 10 10 10 10 10 12 10 10 10 10 10 10 10 10 10 10 10 10 31 34 10 10 10 10 10 10 10 10 10 10 10 10 10 10 20 21 21 26 21 26 26 21
26 21 26 26 26 21 21 22 10 10 10 10 10 10 11 10 10 10 10 10 10 10 10 10 10 10 31 34 10 10 10 10 10 10 10 10 10 10 10 10 10 10 20 21 21 26 21 26 26 21
26 21 26 26 26 21 21 22 10 10 10 10 10 10 10 10 10 10 10 10 10 10 38 32 15 43 31 34 10 10 10 10 10 10 10 10 10 10 10 10 10 10 20 21 21 26 21 26 26 21
26 21 26 26 26 21 21 22 10 10 10 10 10 10 10 10 10 10 10 10 10 10 10 15 15 15 16 34 10 10 10 10 10 10 10 10 10 10 10 10 10 10 20 21 21 26 21 26 26 21
26 21 26 26 26 21 21 22 10 10 10 10 10 10 10 10 10 10 10 10 10 10 15 15 15 16 16 15 10 10 10 10 10 10 10 10 10 10 10 10 10 10 20 21 21 26 21 26 26 21
26 21 26 26 26 21 21 22 10 10 10 10 10 10 10 10 10 10 10 10 10 15 16 44 45 46 47 15 32 32 32 32 10 10 10 10 10 10 10 10 10 10 20 21 21 26 21 26 26 21
26 21 26 26 26 21 21 22 10 10 10 10 10 10 10 10 10 10 10 10 10 16 16 48 49 50 51 31 31 31 31 31 10 10 10 10 10 10 10 10 10 10 20 21 21 26 21 26 26 21
26 21 26 26 26 21 21 22 10 10 10 10 10 10 10 10 10 10 10 10 10 15 16 52 53 54 55 10 10 10 10 10 10 10 10 10 10 10 10 10 10 10 20 21 21 26 21 26 26 21
26 21 26 26 26 21 21 22 10 10 10 10 10 10 10 10 10 10 10 10 10 10 16 56 57 58 59 15 10 10 10 10 10 10 10 10 10 10 10 10 10 10 20 21 21 26 21 26 26 21
26 21 26 26 26 21 21 22 10 10 10 10 10 10 10 10 10 10 10 10 10 10 15 15 16 15 16 16 10 10 10 10 10 10 10 10 10 10 10 10 10 10 20 21 21 26 21 26 26 21
26 21 26 26 26 21 21 22 10 10 10 10 10 10 10 10 10 10 10 10 10 10 10 10 15 15 15 10 10 10 10 10 10 10 10 10 10 10 10 10 10 10 20 21 21 26 21 26 26 21
26 21 26 26 26 21 21 22 10 10 10 10 10 10 10 10 10 10 10 10 10 10 10 10 10 10 10 10 10 10 10 10 10 10 10 10 10 10 10 10 10 10 20 21 21 26 21 26 26 21
26 21 26 26 26 21 21 22 10 10 10 10 10 10 10 10 10 10 10 10 10 10 10 10 10 10 10 10 10 10 10 10 10 10 10 10 10 10 10 10 10 10 20 21 21 26 21 26 26 21
26 21 26 26 26 21 21 22 10 10 10 10 10 10 10 10 10 10 10 10 10 10 10 10 10 10 10 10 10 10 10 10 10 10 10 10 10 10 10 10 10 10 20 21 21 26 21 26 26 21
26 21 26 26 26 21 21 22 10 10 10 10 10 10 10 10 10 10 10 10 10 10 10 10 10 10 10 10 10 10 10 10 10 10 10 10 10 10 10 10 10 10 20 21 21 26 21 26 26 21
26 21 26 26 26 21 21 22 10 10 10 10 10 10 10 10 10 10 10 10 10 10 10 10 10 10 10 10 10 10 10 10 10 10 10 10 10 10 10 10 10 10 20 21 21 26 21 26 26 21
26 21 26 26 26 21 21 22 10 10 10 10 10 10 10 10 10 10 10 10 10 10 10 10 10 10 10 10 10 10 10 10 10 10 10 10 10 10 10 10 10 10 20 21 21 26 21 26 26 21
26 21 26 26 26 21 21 22 10 10 10 10 10 10 10 10 10 10 10 10 10 10 10 10 10 10 10 10 10 10 10 10 10 10 10 10 10 10 10 10 10 10 20 21 21 26 21 26 26 21
26 21 26 26 26 21 21 22 10 10 10 10 10 10 10 10 10 10 10 10 10 10 10 10 10 10 10 10 10 10 10 10 10 10 10 10 10 10 10 10 10 10 20 21 21 26 21 26 26 21
26 21 26 26 26 21 21 22 10 10 10 10 10 10 10 10 10 10 10 10 10 10 10 10 10 10 10 10 10 10 10 10 10 10 10 10 10 10 10 10 10 10 20 21 21 26 21 26 26 21
26 21 26 26 26 21 21 22 10 10 10 10 10 10 10 10 10 10 10 10 10 10 10 10 10 10 10 10 10 10 10 10 10 10 10 10 10 10 10 10 10 10 20 21 21 26 21 26 26 21
26 21 26 26 26 21 21 22 10 10 10 10 10 10 10 10 10 10 10 10 10 10 10 10 10 10 10 10 10 10 10 10 10 10 10 10 10 10 10 10 10 10 20 21 21 26 21 26 26 21
26 21 26 26 26 21 21 22 10 10 10 10 10 10 10 10 10 10 10 10 10 10 10 10 10 10 10 10 10 10 10 10 10 10 10 10 10 10 10 10 10 10 20 21 21 26 21 26 26 21
26 21 26 26 26 21 21 22 10 10 10 10 10 10 10 10 10 10 10 10 10 10 10 10 10 10 10 10 10 10 10 10 10 10 10 10 10 10 10 10 10 10 20 21 21 26 21 26 26 21
26 21 26 26 26 21 21 22 10 10 10 10 10 10 10 10 10 10 10 10 10 10 10 10 10 10 10 10 10 10 10 10 10 10 10 10 10 10 10 10 10 10 20 21 21 26 21 26 26 21
26 21 26 26 26 21 21 22 10 10 10 10 10 10 10 10 10 10 10 10 10 10 10 10 10 10 10 10 10 10 10 10 10 10 10 10 10 10 10 10 10 10 20 21 21 26 21 26 26 21
26 21 26 26 26 21 21 22 10 10 10 10 10 10 10 10 10 10 10 10 10 10 10 10 10 10 10 10 10 10 10 10 10 10 10 10 10 10 10 10 10 10 20 21 21 26 21 26 26 21
21 21 21 21 21 26 26 28 18 18 18 18 18 18 18 18 18 18 18 18 18 18 18 18 18 18 18 18 18 18 18 18 18 18 18 18 18 18 18 18 18 18 29 21 21 21 21 26 21 26
21 21 21 21 21 26 26 21 26 26 21 26 26 21 26 21 26 21 26 26 26 21 21 26 21 26 21 26 26 21 21 26 26 26 21 21 26 21 26 21 21 26 26 21 21 21 21 26 21 26
21 21 21 21 21 26 26 26 26 26 21 26 26 21 26 26 26 21 26 26 26 21 26 26 26 26 21 26 26 21 21 26 26 26 21 21 21 21 21 21 21 26 26 21 21 21 21 21 21 26
21 21 21 21 21 26 26 21 26 26 21 26 26 21 26 21 26 21 26 26 26 21 21 26 21 26 21 26 26 21 21 26 26 26 21 21 26 21 26 21 21 26 26 21 21 21 21 26 21 26
21 21 21 21 21 26 26 21 26 26 21 26 26 21 21 21 26 21 26 26 26 21 26 26 21 26 21 26 26 21 21 26 26 26 21 21 21 26 21 26 21 26 26 21 21 21 26 21 21 26
21 21 21 21 21 26 26 21 26 26 21 26 26 21 26 21 26 21 26 26 26 21 21 26 21 26 21 26 26 21 21 26 26 26 21 21 26 21 26 21 21 26 26 21 21 21 21 26 21 26